FFFFFFFFFFFFFFFFFFFF
FFFFFFFFFFFFFFFFFFFF
FFFFFFFFFFFFFFFFFFFF
FFFFFFFFFFFFFFFFFFFF
FFFFFFFFFFFFFFFFFFFF
FFFFFFFFFFFFFFFFFFFV
FFFFFFFFFFFFFFFFFFFV
FFFFFFFFFFFFFFFFFFFV
FFFFFFFFFFFFFFFFFFFV
FFFFFFFFFFFFFFFFFFFV
FFFFFFFFFFFFFFFFFFFF
FFFFFFFFFFFFFFFFFFFF
FFFFFFFFFFFFFFFFFFFF
FFFFFFFFFFFFFFFFFFFF
FFFFFVVVVVVVVVVFFFFF