VVVVVVVVVVVVVVVVVVVVVVVVVVVVVVVVVVVVVVVVVVVVVVVVVVVVVVVVVVVVVVVVVVVVVVVVVVVVVVVVVVVVVVVVVVVVVVVVVVVVVVVVVVVVVVVVVVVVVVVVVVVVVVVVVVVVVVVVVVVVVVVVVVVVVVVVVVVVVVVVVVVVVVVVVVVVVVVVVVVVVVVVVVVVVVVVVVVVVVVVVVVVVVVVVVVV
VVVVVVVVVVVVVVVVVVVYYYVVVVVVVVVVVVVVYYYYVVVVVVVVVVVVVVVVVVVVVVVVVVVYYYVVVVVVVVVVVVVVYYYYVVVVVVVVVVVVVVVVVVVVVVVVVVVYYYVVVVVVVVVVVVVVYYYYVVVVVVVVVVVVVVVVVVVVVVVVVVVYYYVVVVVVVVVVVVVVYYYYVVVVVVVVVVVVVVAVVVVVVVVVVVVV
VVVVVVVVYYYVVVVVVVVYYYVVVVVYYYYYVVVVYYYYVVVVVVVVVVVVVVVVYYYVVVVVVVVYYYVVVVVYYYYYVVVVYYYYVVVVVVVVVVVVVVVVYYYVVVVVVVVYYYVVVVVYYYYYVVVVYYYYVVVVVVVVVVVVVVVVYYYVVVVVVVVYYYVVVVVYYYYYVVVVYYYYVVVVVVVVVVVVVVAVYYYVVVVVVVVV
VVVVVVVVYYYVVVVVVVVVVVVVVVVYYYYYVVVVVVVVVVVVVVVVVVVVVVVVYYYVVVVVVVVVVVVVVVVYYYYYVVVVVVVVVVVVVVVVVVVVVVVVYYYVVVVVVVVVVVVVVVVYYYYYVVVVVVVVVVVVVVVVVVVVVVVVYYYVVVVVVVVVVVVVVVVYYYYYVVVVVVVVVVVVVVVVVVVVVVAVVVVVVVVVVVVV
VVVVVVVVVVVVVVVVVVVVVVLVVVVVVVVVVVVVVVVVVVVVVVVVVVVVVVVVVVVVVVVVVVVVVVVVVVVVVVVVWWWWWWWWVVVWWWLVVVVVVVVVVVVVVLVVVVVVVVVVVWWWVVVVWLLWVVVVVVVVVVVVVVVVVVVVVVVVVVVVVVVVVVVVVVVVVVVVVVVVVVVVVVVVXXVVVVVVVVAVVVVVVVVVVVVV
VVVVVVVVVVVVVVVVVVVVVVVVVVVVVVVVVVVVVVVVVVVVVVVVVVVVVVVVVVVVVVVVVVVVVVVVVVVVVVVVVVVVVVVVVVVVVVVVVVVVVVVVVVVVVVVVVVVVVVVVVVVVVVVVVVVVVVVVVVVVVVVVVVVVVVVVVVVVVVVVVVVVVVVVVVVVVVVVVVVVVVVVVVVXXXVVVVVVVVAVVVVVVVVVVVVV
VVVVVVVVVVVVVVVVVVVVVVVVVVVVVVVVVVVVVVVVVVVVVVVVVVVVVVVVVVVVVVVVVVVVVVVVVVVVVVVVVVVVVVVVVVVVVVVVVVVVVVVVVVVVVVVVVVVVVVVVVVVVVVVVVVVVVVVVVVVVVVVVVVVVVVVVVVVVVVVVVVVVVVVVVVVVVVVVVVVVVVVVVVXXXXVVVVVVVVAVVVVVVVVVVVVV
VVVVVVVVVVVVVVVVVVVVVVVVVVVVVVVVVVVVVVVVVVVVVVVVVVVVVVVEEVVVVVVVDVVVVVVVVVVVVVVVVVVVVVVVVVVVVVVVVVVVVVVVVVVVVVVVVVVVVVVVVVVVVVVVVVVVVVVVVVVVVVVVVVVVVVVVVVVVVVVVVVVVVVVVVVVVVVVVVVVVVVVVVXXXXXVVVVVVVVAVVVCCCCCVVVVV
VVVVVVVVVVVVVVVVLVVVWLWLWVVVVVVVVVVVVVVVVVVVVVPPVVVVVVVPPVVVVVVVVVVVVVVVVVVVVWLWVVVVVVVVVVVVVVWVVVVVWDVVVVLVVLVVLVVVVVWVVVVVVVVVVWWVVVVVVXVVXVVVVVVVVVVXXVVXVVVVVVVVVVVVWWLWVVVVVVVVVVVVXXXXXXVVVVVVVVAVVVCCCCCVVVVV
HHHHHVVVVVVVVVVVVVVVVVVVVVVVVVVVVVVVVVPPVVVVVVPPHHHHHVVPPVVVVVVVVVVVVVVVVVVVVVVVVVVVVVVVVVVVVVVVHHHHHVVVVVVVVVVVVVVVVVVVVVVVVVVVVVVVVVVVXXVVXXVVVVVVVVXXXVVXXVVVVVVOOVVVVVVVVVVVVVVVVVVXXXXXXXVVHHHHHVAVVVCCCCCVVVVV
HHHHHVVVVVVVVVVVHHHVVVVVVVVVPPVVVVVVVVPPVVVVVVPPHHHHHVVPPVVVVVVVHHHVVVVVVVVVVVVVVVVVVVVVVVVVVVVVHHHHHVVVVVVVVVVVHHHVVVVVVVVVVVVVVVVVVVVXXXVVXXXVVVVVVXXXXVVXXXVVHHHPPVVVVVVVVVVVVVVPPVXXXXXXXXVVHHHHHVAVVVCCCCCVHHHV
HHHHHVVVVVVBBBBBHHHVVVVBBBVVPPVVVVVVVVPPVBBBBVPPHHHHHVVPPVVBBBBBHHHVVVVBBBVVVVVVVVVVVVVVVBBBBVVVHHHHHVVVVVVBBBBBHHHVVVVBBBVVVVVVVVVVVVXXXXVVXXXXVVVVXXXXXVVXXXXVHHHPPVVBBBVVVVVVVVVPPXXXXXXXXXVVHHHHHVXVVVCCCCCVHHHV
FFFFFFFFFFFFFFFFFFFFFFFFFFFFFFFFFFFFFFFFFFFFFFFFFFFFFFFFFFFFFFFFFFFVVFFFFFFFFFFFFVVVFFFFFFFFFFFFFFFFFFFFFFFFFFFFFFFFFFFFFFFFFFFFFFFFFFFFFFFFFFFFFFFFFFFFFVVFFFFFFFFFFFFFFFFFFFFFFFFFFFFFFFFFFFFFFFFFFFFFFFFFFFFFFFFF
FFFFFFFFFFFFFFFFFFFFFFFFFFFFFFFFFFFFFFFFFFFFFFFFFFFFFFFFFFFFFFFFFFFVVFFFFFFFFFFFFVVVFFFFFFFFFFFFFFFFFFFFFFFFFFFFFFFFFFFFFFFFFFFFFFFFFFFFFFFFFFFFFFFFFFFFFVVFFFFFFFFFFFFFFFFFFFFFFFFFFFFFFFFFFFFFFFFFFFFFFFFFFFFFFFFF
